24 16
0 0 0 0 0 0 0 0 0 0 0 0 0 0 0 0 0 0 0 0 0 0 0 0 
0 0 0 0 0 0 0 0 0 0 0 0 0 0 0 0 0 0 0 0 0 0 0 0 
0 0 0 0 0 0 0 0 0 0 0 0 0 0 0 0 0 0 0 0 0 0 0 0 
0 0 0 0 0 0 0 0 0 0 0 0 0 0 0 0 0 0 0 0 0 0 0 0 
0 0 0 0 0 0 0 0 0 0 0 0 0 0 0 0 0 0 0 0 0 0 0 0 
0 0 0 0 0 0 0 0 0 0 0 0 0 0 0 0 0 0 0 0 0 0 0 0 
0 0 0 0 0 0 0 0 0 0 0 0 0 0 0 0 0 0 0 0 0 0 0 0 
0 0 0 0 0 0 0 0 3 1 1 1 1 1 1 3 0 0 0 0 0 1 0 0 
0 0 0 0 0 0 0 0 1 3 1 3 3 1 3 1 0 0 0 1 0 1 0 0 
0 0 0 1 1 1 0 0 1 1 3 1 1 3 1 1 0 0 0 1 0 1 0 0 
0 0 0 1 2 1 1 1 1 3 1 2 2 1 3 1 1 1 1 1 1 1 1 0 
0 0 0 1 2 1 1 1 1 3 1 2 2 1 3 1 1 1 1 1 1 1 1 0 
0 0 0 1 1 1 0 0 1 1 3 1 1 3 1 1 0 0 0 1 0 1 0 0 
0 0 0 0 0 0 0 0 1 3 1 3 3 1 3 1 0 0 0 1 0 1 0 0 
0 0 0 0 0 0 0 0 3 1 1 1 1 1 1 3 0 0 0 0 0 1 0 0 
0 0 0 0 0 0 0 0 0 0 0 0 0 0 0 0 0 0 0 0 0 0 0 0 
0 
17
8 14 2
15 14 2
15 7 2
8 7 2
9 14 1
10 13 1
13 13 1
14 14 1
11 7 1
12 7 1
19 13 1
19 8 1
21 7 1
21 14 1
4 11 4
4 10 4
22 11 0
