24 16
0 0 0 0 0 0 0 0 0 0 0 0 0 0 0 0 0 0 0 0 0 0 0 0 
0 0 0 0 1 0 1 0 0 0 1 0 0 0 0 0 1 1 1 0 0 0 0 0 
0 0 0 0 1 1 1 1 0 1 1 0 0 0 0 0 1 0 1 0 0 0 0 0 
0 0 0 0 1 1 1 1 1 1 1 0 0 0 0 0 1 0 1 0 0 0 0 0 
0 0 0 0 1 1 1 1 1 1 1 0 1 1 1 1 1 0 1 0 0 0 0 0 
0 0 0 0 1 1 1 1 1 1 1 0 1 0 0 0 0 0 1 0 0 0 0 0 
0 0 0 0 1 1 1 1 1 1 1 0 1 1 1 1 0 0 1 0 1 1 1 0 
0 1 1 0 1 1 1 1 1 1 1 0 1 1 0 0 0 0 1 0 1 1 1 0 
0 1 1 1 1 1 1 1 1 1 1 1 1 1 0 0 0 0 1 0 1 1 1 0 
0 1 1 0 1 1 1 1 1 1 1 0 1 1 0 0 0 0 1 0 0 1 0 0 
0 0 0 0 1 1 1 1 1 1 1 0 1 1 1 1 0 0 1 0 3 3 3 0 
0 0 0 0 1 1 1 1 1 1 1 0 1 0 0 0 0 0 1 0 3 3 3 0 
0 0 0 0 1 1 1 1 1 1 1 0 1 1 1 1 1 0 1 0 0 1 0 0 
0 0 0 0 1 1 1 1 0 1 1 0 0 0 0 0 1 0 1 1 0 1 0 0 
0 0 0 0 1 0 1 0 0 0 1 0 0 0 0 0 1 1 1 1 1 1 1 0 
0 0 0 0 0 0 0 0 0 0 0 0 0 0 0 0 0 0 0 0 0 0 0 0 
0 
22
4 14 1
5 13 1
6 14 1
7 13 1
8 12 1
9 13 1
10 14 1
4 1 1
5 2 1
6 1 1
7 2 1
8 3 1
9 2 1
10 1 1
1 8 0
20 11 3
22 10 3
21 7 4
22 14 3
16 14 3
15 10 3
15 6 3
